307 307 307 307 307 307 307 307 307 307 307 307 307 307 307 307 307 307 307 307 307 307 307 307 307 307 307 307 307 307 307 307 307 307 307 307 307 307 307 307 307 307 307 307 307 307 307 307 307 307 307 307 307 307 307 307 307 307 307 307 307 307
307 307 307 307 307 307 307 307 307 307 307 307 307 307 307 307 307 307 307 307 307 307 307 307 307 307 307 307 307 307 307 307 307 307 307 307 307 307 307 307 307 307 307 307 307 307 307 307 307 307 307 307 307 307 307 307 307 307 307 307 307 307
307 307 307 307 307 307 307 307 307 307 307 307 307 307 307 307 307 307 307 307 307 307 307 307 307 307 307 307 307 307 307 307 307 307 307 307 307 307 307 307 307 307 307 307 307 307 307 307 307 307 307 307 307 307 307 307 307 307 307 307 307 307
307 307 307 307 307 307 307 307 307 307 307 307 307 307 307 307 307 307 307 307 307 307 307 307 307 307 307 307 307 307 307 307 307 307 307 307 307 307 307 307 307 307 307 307 307 307 307 307 307 307 307 307 307 307 307 307 307 307 307 307 307 307
307 307 307 307 307 307 307 307 307 307 307 307 307 307 307 307 307 307 307 307 307 307 307 307 307 307 307 307 307 307 307 307 307 307 307 307 307 307 307 307 307 307 307 307 307 307 307 307 307 307 307 307 307 307 307 307 307 307 307 307 307 307
307 307 307 307 307 307 307 307 307 307 307 307 307 307 307 307 307 307 307 307 307 307 307 307 307 307 307 307 307 307 307 307 307 307 307 307 307 307 307 307 307 307 307 307 307 307 307 307 307 307 307 307 307 307 307 307 307 307 307 307 307 307
307 307 307 307 307 307 307 307 307 307 307 307 307 307 307 307 307 307 307 307 307 307 307 307 307 307 307 307 307 307 307 307 307 307 307 307 307 307 307 307 307 307 307 307 307 307 307 307 307 307 307 307 307 307 307 307 307 307 307 307 307 307
307 307 307 307 307 307 307 307 307 307 307 307 307 307 307 307 307 307 307 307 307 307 307 307 307 307 307 307 307 307 307 307 307 307 307 307 307 307 307 307 307 307 307 307 307 307 307 307 307 307 307 307 307 307 307 307 307 307 307 307 307 307
307 307 307 307 307 307 307 307 307 307 307 307 307 307 307 307 307 307 307 307 307 307 307 307 307 307 307 307 307 307 307 307 307 307 307 307 307 307 307 307 307 313 313 313 313 313 313 313 307 307 307 307 307 307 307 307 307 307 307 307 307 307
307 307 307 307 307 307 307 307 307 307 307 307 307 307 307 307 307 307 307 307 307 307 313 313 307 307 307 307 307 307 307 307 307 307 307 307 307 307 307 307 308 311 305 311 305 207 311 305 306 307 307 307 307 307 307 307 307 307 307 307 307 307
307 307 307 307 307 307 307 307 307 307 307 307 307 313 313 307 307 307 307 307 313 314 305 311 312 313 313 313 307 307 307 307 307 307 307 307 307 307 307 307 308 311 305 207 311 311 207 305 306 307 307 307 307 307 307 307 307 307 307 307 307 307
307 307 307 307 307 307 307 307 307 307 307 308 311 326 320 312 313 313 313 314 311 311 207 311 305 326 320 305 312 313 313 313 313 313 313 313 313 313 307 307 308 305 305 311 311 305 311 305 306 307 307 307 307 307 307 307 307 307 307 307 307 307
307 307 307 307 307 307 307 307 307 307 307 308 311 305 326 311 305 311 311 311 326 207 311 305 311 305 207 311 305 326 320 305 305 311 305 311 311 207 306 307 308 207 311 327 311 207 207 311 306 307 307 307 307 307 307 307 307 307 307 307 307 307
307 307 307 307 307 307 307 307 307 307 307 314 326 305 311 327 320 207 311 305 311 311 207 311 305 326 207 305 311 311 305 327 327 311 305 305 326 311 306 307 308 305 305 550 000 000 207 311 306 307 307 307 307 307 307 307 307 307 307 307 307 307
307 307 307 307 307 307 307 307 307 307 308 311 305 207 311 311 207 305 018 305 311 311 305 311 305 207 311 327 311 207 207 311 305 305 311 327 320 207 306 307 308 311 305 501 000 000 327 306 307 307 307 307 307 307 307 307 307 307 307 307 307 307
307 307 307 307 307 307 307 307 307 307 308 311 311 311 305 305 305 028 120 027 550 000 000 320 553 000 000 554 000 000 551 000 000 305 311 311 305 311 306 307 308 311 311 305 327 327 311 306 307 307 307 307 307 307 307 307 307 307 307 307 307 307
307 307 307 307 307 307 307 307 307 307 308 305 305 326 320 311 305 028 120 027 500 000 000 327 501 000 000 503 000 000 505 000 000 207 311 305 311 305 306 307 308 311 305 207 311 327 311 306 307 307 307 307 307 307 307 307 307 307 307 307 307 307
307 307 307 307 307 307 307 307 307 307 308 305 327 311 311 305 207 028 120 021 018 018 018 018 018 018 018 018 018 018 018 018 018 018 018 018 018 305 306 307 308 311 305 326 311 305 311 306 307 307 307 307 307 307 307 307 307 307 307 307 307 307
307 307 307 307 307 307 307 307 307 307 307 302 311 207 207 327 305 028 120 031 120 030 032 120 120 120 031 120 120 030 120 031 120 032 120 120 120 027 306 307 308 311 311 326 207 311 305 306 307 307 307 307 307 307 307 307 307 307 307 307 307 307
307 307 307 307 307 307 307 307 307 307 307 308 305 018 018 018 018 019 031 020 024 024 024 024 024 024 024 024 024 024 024 024 024 024 025 031 120 027 306 307 308 311 305 207 311 305 326 306 307 307 307 307 307 307 307 307 307 307 307 307 307 307
307 307 307 307 307 307 307 307 307 307 307 308 028 120 031 032 120 031 120 027 554 000 000 305 326 552 000 000 555 000 000 550 000 000 028 120 032 027 306 307 308 311 305 207 311 311 207 305 306 307 307 307 307 307 307 307 307 307 307 307 307 307
307 307 307 307 307 307 307 307 307 307 307 314 028 032 120 120 031 120 120 027 505 000 000 305 327 504 000 000 502 000 000 505 000 000 028 120 120 027 306 307 308 305 305 311 327 320 207 311 306 307 307 307 307 307 307 307 307 307 307 307 307 307
307 307 307 307 307 307 307 307 307 307 308 311 311 024 024 024 024 025 032 021 018 018 018 018 018 018 018 018 018 018 018 018 018 018 019 030 120 027 306 307 308 311 305 311 305 326 305 305 306 307 307 307 307 307 307 307 307 307 307 307 307 307
307 307 307 307 307 307 307 307 307 307 308 305 320 207 311 311 305 028 120 120 031 032 120 031 120 120 031 032 120 031 120 031 120 120 031 120 120 027 306 307 308 311 305 327 305 207 311 305 306 307 307 307 307 307 307 307 307 307 307 307 307 307
307 307 307 307 307 307 307 307 307 307 308 311 305 311 326 207 311 028 120 020 024 024 024 024 024 024 024 024 024 024 024 024 024 024 024 024 024 305 306 307 308 305 305 311 305 554 000 000 306 307 307 307 307 307 307 307 307 307 307 307 307 307
307 307 307 307 307 307 307 307 307 307 308 311 311 305 320 207 305 028 031 027 300 301 301 301 301 301 301 301 301 301 301 301 301 301 301 301 301 307 307 307 308 311 207 207 311 505 000 000 306 307 307 307 307 307 307 307 307 307 307 307 307 307
307 307 307 307 307 307 307 307 307 307 307 302 327 311 311 311 305 028 032 027 306 307 307 307 307 307 307 307 307 307 307 307 307 307 307 307 307 307 307 307 308 305 207 311 305 326 320 305 306 307 307 307 307 307 307 307 307 307 307 307 307 307
307 307 307 307 307 307 307 307 307 307 307 308 311 305 305 305 305 028 032 027 312 313 313 313 313 313 313 313 313 313 313 313 313 313 313 313 313 313 313 313 314 311 305 311 327 305 311 327 306 307 307 307 307 307 307 307 307 307 307 307 307 307
307 307 307 307 307 307 307 307 307 307 307 308 327 305 305 320 207 028 032 027 305 326 550 000 000 554 000 000 305 553 000 000 551 000 000 552 000 000 320 305 311 320 207 311 305 311 311 305 306 307 307 307 307 307 307 307 307 307 307 307 307 307
307 307 307 307 307 307 307 307 307 307 307 308 305 320 305 305 305 028 032 027 305 311 502 000 000 504 000 000 311 505 000 000 501 000 000 503 000 000 305 311 311 305 327 305 207 311 305 306 307 307 307 307 307 307 307 307 307 307 307 307 307 307
307 307 307 307 307 307 307 307 307 307 307 308 311 311 207 311 305 028 032 021 018 018 018 018 018 018 018 018 018 018 018 018 018 018 018 018 018 018 018 018 018 018 018 311 311 327 311 306 307 307 307 307 307 307 307 307 307 307 307 307 307 307
307 307 307 307 307 307 307 307 307 307 307 308 305 311 311 326 311 028 031 120 030 032 120 120 120 031 120 120 030 120 031 120 120 120 030 032 120 120 120 031 120 120 030 027 311 305 326 306 307 307 307 307 307 307 307 307 307 307 307 307 307 307
307 307 307 307 307 307 307 307 307 307 307 308 311 311 207 305 305 311 024 024 024 024 024 024 024 024 024 024 024 024 024 024 024 024 024 024 024 024 024 024 024 024 024 311 305 305 311 306 307 307 307 307 307 307 307 307 307 307 307 307 307 307
307 307 307 307 307 307 307 307 307 307 307 308 305 326 311 305 311 311 311 326 207 311 305 311 305 207 311 305 326 320 305 305 311 305 305 207 311 326 550 000 000 305 311 305 326 305 305 306 307 307 307 307 307 307 307 307 307 307 307 307 307 307
307 307 307 307 307 307 307 307 307 307 307 307 302 311 305 326 207 305 311 311 311 326 207 311 305 311 305 207 311 305 326 305 305 326 320 311 311 305 502 000 000 305 326 305 207 305 311 312 307 307 307 307 307 307 307 307 307 307 307 307 307 307
307 307 307 307 307 307 307 307 307 307 307 307 308 305 311 327 320 207 311 305 311 311 207 311 305 326 207 305 311 311 305 311 327 305 311 327 320 207 311 305 311 311 305 311 311 305 311 305 306 307 307 307 307 307 307 307 307 307 307 307 307 307
307 307 307 307 307 307 307 307 307 307 307 307 307 301 301 301 301 302 326 207 311 305 311 305 311 311 305 311 305 305 311 305 311 207 305 311 311 311 326 207 311 305 311 305 207 320 311 311 306 307 307 307 307 307 307 307 307 307 307 307 307 307
307 307 307 307 307 307 307 307 307 307 307 307 307 307 307 307 307 308 326 207 311 305 311 305 207 311 305 326 305 305 311 311 305 305 326 320 311 311 305 327 327 311 305 305 326 552 000 000 306 307 307 307 307 307 307 307 307 307 307 307 307 307
307 307 307 307 307 307 307 307 307 307 307 307 307 307 307 307 307 307 301 302 305 326 207 311 305 311 305 207 311 305 326 305 305 300 301 301 301 301 301 301 301 301 301 302 207 502 000 000 306 307 307 307 307 307 307 307 307 307 307 307 307 307
307 307 307 307 307 307 307 307 307 307 307 307 307 307 307 307 307 307 307 307 301 301 301 301 301 302 311 311 326 207 311 305 311 306 307 307 307 307 307 307 307 307 307 307 301 301 301 301 307 307 307 307 307 307 307 307 307 307 307 307 307 307
307 307 307 307 307 307 307 307 307 307 307 307 307 307 307 307 307 307 307 307 307 307 307 307 307 307 301 301 301 301 301 301 301 310 307 307 307 307 307 307 307 307 307 307 307 307 307 307 307 307 307 307 307 307 307 307 307 307 307 307 307 307
307 307 307 307 307 307 307 307 307 307 307 307 307 307 307 307 307 307 307 307 307 307 307 307 307 307 307 307 307 307 307 307 307 307 307 307 307 307 307 307 307 307 307 307 307 307 307 307 307 307 307 307 307 307 307 307 307 307 307 307 307 307
307 307 307 307 307 307 307 307 307 307 307 307 307 307 307 307 307 307 307 307 307 307 307 307 307 307 307 307 307 307 307 307 307 307 307 307 307 307 307 307 307 307 307 307 307 307 307 307 307 307 307 307 307 307 307 307 307 307 307 307 307 307
