311 305 305 305 028 120 027 550 000 000 320 553 000 000 554 000 000 551 000 000
305 311 311 305 028 120 027 500 000 000 327 501 000 000 503 000 000 505 000 000
311 311 305 311 028 120 021 018 018 018 018 018 018 018 018 018 018 018 018 018
305 311 311 305 028 120 031 120 030 032 120 120 120 031 120 120 030 120 031 120
018 018 018 018 019 031 020 024 024 024 024 024 024 024 024 024 024 024 024 024
120 031 032 120 031 120 027 554 000 000 305 326 552 000 000 555 000 000 550 000
032 120 120 031 120 120 027 505 000 000 305 327 504 000 000 502 000 000 505 000
024 024 024 024 025 032 021 018 018 018 018 018 018 018 018 018 018 018 018 018
305 311 311 305 028 120 120 031 032 120 031 120 120 031 032 120 031 120 031 120
311 311 305 311 028 120 020 024 024 024 024 024 024 024 024 024 024 024 024 024
305 311 311 305 028 031 027 300 301 301 301 301 301 301 301 301 301 301 301 301
311 305 305 305 028 032 027 312 313 313 313 313 313 313 313 313 313 313 313 313
